00000000000000
01111111111110
01001001010010
01001010010010
01111111111110
01001000010010
01111100111010
01000100101110
31110111100010
00010100111112
01110100010100
01010101111110
01011111100010
01000100111010
01111100101010
00001000101010
01111111111110
01010100100010
01010100101010
01111111111110
00000000000000